vv_vv_vv_vv_vv_vv_vv_vv_vv
## ## ## ## ## ## ## ## ##
||_||_||_||_|| ## ## ## ##
## ## ## ## ## ## ## ## ##
||_||_|| ## ||_||_||_||_||
## ## ## ## ## ## ## ## ##
## ## ||_||_|| ## ||_||_||
## ## ## ## ## ## ## ## ##
^^_^^_^^_||_||_||_^^_^^_^^
         ## ## ##         
         ## ||_||___      
         ## ## ##         
      ___||_|| ##         
         ## ## ##         
         ## ||_||___      
         ## ## ##         
      ___^^_||_^^___      
 -uuuu-     ##     -uuuu- 
            ##            
            ##            
            ^^            
                          
                          
       -uuuu--uuuu-       