v____v_v___v_______v
#    # #   #       #
|____|_^_v_^_v_____|
#    #   #   #     #
|____^_v_|   |_____|
#      # #   #     #
^____v_|_|_v_^_____^
     # # # #        
     | # |_^__v     
     # # #    #     
     |_^_^____|     
luuur#        #luuur
     |        #     
     #        #     
v__v_|        |___v 
# # #         #   # 
|_|_|         |_v_| 
# # #luuucuuur# # # 
^_^_|         |_^_^ 
    #         #     
    |_v____v__|     
    # #    #  #     
    ^_^____^__^     
luuur         luuur 